input	target
Imisebenzi inqabile.	Jobs are scarce.
Kutheni uwuyekile umsebenzi wakho efama	Why did you leave your job on the farm
Ndisebenza evenkileni yomhlobo wam.	I work at my friend's shop.
uTom akawuthandi umsebenzi wakhe.	Tom doesn't like his work.
uTom usebenza ekhaya.	Tom works at home.
Kutheni uTom esebenza ekhaya	Why does Tom work at home
Usithetha kakuhle isiXhosa.	You speak Xhosa well.
Ndiyakuthanda kakhulu ukusebenza nabantu.	I really like working with people.
Ndiyakuthanda kakhulu ukusebenza nabantu.	I love working with people.
Ndiyakuthanda kakhulu ukusebenza nabantu.	I very much like working with people.
Umntu ngumntu ngabantu.	People are people through other people.
Umntu ngumntu ngabantu.	A person is a person through other people.
Andifuni ukuthetha.	I don't want to talk.
Andifuni ukuhamba.	I don't want to go.
Unempumlo enkulu.	You have a big nose.
Ndingayifumana phi ivuvuzela	Where can I get a vuvuzela
Andifuni ukujonga.	I don't want to look.
Andifuni ukudlala.	I don't want to play.
Nceda,ndifuna ukukubona.	I'd like to see you,please.
Andazi nto.	I don't need anything.
Andifuni ukulela.	I don't want to sleep.
Ndiyayaz uzothi hayi.	I know you're going to say no.
Andifuni ukuhlala.	I don't want to stay.
Uphi ngoku	Where is it now
Unxibe njengomfazi.	He dressed up as a woman.
Uyalikhumbula igama lakhe	Do you remember her name
UTom ebesoyika kakhulu.	Tom was very scared.
Andifuni ukulila.	I don't want to cry.
Asikho isizatho bawoyike.	There's no reason to be afraid.
Funeke uzame ukundiqonda.	You must try to understand me.
Sizakwala ukwamkela isindululo.	We may refuse to accept the proposal.
Uchithe ixesha ekincinci kwizifundo zakhe.	He spent a little time on his lessons.
Andizukuthatha nxaxheba kwintekelelo.	I won't participate in speculation.
Ndizame ukuzibulala kabini.	I've attempted suicide twice.
Ilizwe laseTurkey livelisa izambiwa phantsi komhlaba ezininzi.	Turkey produces a lot of minerals.
Ngamanye amaxesha ubceda umama wakhe.	She sometimes helps her mother.
Ngaphandle kokuba ngumqabaqaba,andikwazi ukuba nomsebenzi olungileyo.	Without my well being,I can't have a good job.
Hey,beka lo nto apho ubuyithatha khona.	Hey,put that back.
Hey,yintoni enithetha ngayo	Hey,what are you guys talking about
Ndidibene naye izolo kwisitishi senqwelo moya.	I ran into him yesterday at the airport.
Bendifuna ukubukela umboniso bhanyabhanya owoyikisayo,kodwa intombi yam iyoyika,saqesha ohlekisayo.	I wanted to watch a horror movie,but my girlfriend is scared and rented comedy instead.
Ngelinye ixesha ufuna ukuchitha imini yonke ungenzi nto.	Sometimes you just want to spend the whole day doing nothing.
Impuku ngenene iyasazi apho sikhoyo isonka samanzi.	The mouse sure knows where the cheese is located.
Imvula iyekile.	The rain has stopped.
Ukuba ufuna ipudini,kufuneka utye inyama yakho.	If you want pudding,you must eat your meat.
Sohlelwe yintlungu enzulu.	We suffered a devastating loss.
Uzakuya kwitheko ngokuhlwa nje Ukuba awuyi,masambe siyokubukela umboniso bhanya bhanya.	Will you be going to the party tonight If not,let's go watch a movie.
Andifuni ukuxoka.	I don't want to lie.
Ndineminyaka engu-12,yintoni lento	I'm 12 years old and what is this
Hlala ekhaya.	Stay home.
Ufuna ilifti	Do you want a lift
Kumnandi ukuva njalo.	It's nice to hear that.
Ndandidlala iqakamba ngeentsuku zam zesikolo.	I used to play cricket in my school days.
Ukutyeba kwakhe yingxaki yakhe,ayiyo eyam.	His weight is his problem,not mine.
Ndixakeke kakhulu ukuba ndingaphendula ifowuni.	I’m too busy to answer the phone.
Umama wam uzile kodwa utata wam uhleli ekhaya.	My mother came but my father stayed at home.
UMandela uyathandwa sisizwe.	Mandela is loved by the nation.
Ndithenge izihlangu ngama-R50.	I bought shoes for R50.
Ndithenga ibhayisekile kuDavid.	I’m buying a bicycle from David.
Yayingumfana wathi abantu abakhulu abakho.	It was a young man who said that the adult people were not there.
Abakwantsasana abadinwa kukugcina ucwangco.	The police do not give up in maintaining order.
Abantwana abakhulu badlala endleleni.	The big children are playing in the street.
Umfazi wathi yena wobafundisa rhoqo abakhe abantwana.	The woman said she would always educate her own children.
Khetha abafundi abahlanu ngoku.	Choose five learners now.
Abantwana bakhona,kodwa baphi abantu abadala	The children are here,but where are the older people
Singabantu abadala apha kwaye siyancokola.	We are old people here and we’re chatting.
Kudala,abantu ababomvu babengazise so izibhedlele.	Long ago,traditional people didn’t care about hospitals.
UThomas waphakamisa intloko wabona abantu ababini.	Thomas lifted his head and saw two people.
Zama ukwaba kakhuhle ixesha.	Try to allocate time well.
Yaba iilekese.	Share the sweets.
Aba bantu badlala yiphi imidlalo	Which games do these people play
Nceda unditsalele ngelinye ixesha.	Please phone later.
Uze uzokuhlala nathi ngexesha lebhreyikhi.	Come and sit with us during break.
Hayi,kusekuhle,akukho ngxaki.	No,everything's fine,there’s no problem.
Nali ikhitshi.	Here’s the kitchen.
Molweni.Igama lam nguJabu.	Hello.My name is Jabu.
Ungazifumana isikhombi-ndawo semoski,nesecawe,nesesinagogo	Can you find the signs for the mosque,the church and the synagogue
Baya kubhatala malini ngezi ziselo ezibandayo ezimbini	How much will they pay for the two cooldrinks
Umzukulwana wam uniphathele ezi lekese.	My grandchild has brought you these sweets.
Iintaka zibhabha esibhakabhakeni.	Birds are flying in the sky.
Ndiyathemba ukuba uzolonwabela ixesha lakho apha.	I hope you enjoy your time here.
Wazala abantwana abalishumi.	She gave birth to ten children.
Ekwazini kwam abantu abalula babangamaxhoba ezifo.	To my knowledge young people become victims of diseases.
Abathengi abambalwa bazithenga iimpahla.	A few customers buy the clothes.
Bekukho abantu abambalwa elwandle namhlanje.	There were few people at the beach today.
Abantwana abamhlophe nabamnyama babekhona apho.	There were white and black children there.
Abantwana abamnyama nabo banelungelo lokuba lapha.	Black children also have the right to be here.
Wayalela abantwana abancinci ukuba bagoduke.	She instructed the small children to go home.
Inqununu ibize abantwana abane.	The principal called four children.
Abafazi abangcwele bonke babemthembile uThixo.	All the holy women trusted in God.
Ke bona abantu abangendawo baya kufa.	And those evil people will die.
Le nkqubo ebalulekileyo inceda abantu abaninzi.	This important project helps many people.
Abafundi abanjalo kumele ukuba bahlolwe.	Those kinds of students should be investigated.
Kukho abafundi abaNtsundu abafunda phesheya.	There are African students studying abroad.
Abanye abantu bahleli intlalo ebuhlungu.	Some people live under painful conditions.
Siyamthanda,kodwa abanye abantu abamthandi.	We like him,but some people don't.
Masidibane khona.	Let's meet there.
Siyonwabele iholide yethu.	We enjoyed our holiday.
Ikhefu lam liqala kwiveki ezayo.	My holiday starts next week.
Ndiya apho ilanga likhanya khona.	I’m going where the sun shines.
Ndihlala apho ikhephu likhithika khona.	I live where it snows.
Ndingakunceda Hayi,kulungile.	Can I help you No,it’s ok.
Ndivela eBhayi,ndifike kusasa.	I arrived from P.E.this morning.
Ingaba ndingasebenzisa ifowuni yakho	Can I maybe use your phone
Ndilapha iintsuku ezimbalwa.	I’m here for a few days.
Ndithemba ukuba uzofika ngoMgqibelo.	I hope she will arrive on Saturday.
Ngomso okanye ngoMgqibelo ndizobuyela eBhayi apho ndihlala khona.	Tomorrow or on Saturday I'm going back to P.E.,where I live.
